Some images are taken from RekMOD and other mods, all other images are listed here (they are from the Noun Project):
Acropolis: Acropolis by Wolf Böse
Alcazar: Alcazar of Segovia by Felipe Alvarado
Assyrian Chariot: chariot by ATOM
Auxilliary: horse racing by sergio Morozov
Ballista Elephant: Elephant by FBianchi
Ball Court: Ball by Benjamin Sommerlad
Blood Altar: ara by Denis Moskowitz
Blue Dragon: dragon by Icons Producer
Bandeirante: Pith Helmet by M. Oki Orlando
Bolshoi Theatre: Bolshoi Theatre by Nikita Kozin
Buin: sabre by Robert Bjurshagen
Bullring: Bullfighting by Paulo Valkova
Byzantine Walls: Great Wall of China by Hea Poh Lin
Canals: Gondola by Luis Prado
Carpenthom: Chariot and Horse by Andrew Doane
Chasqui: Runner by Vectorstall
Clibanarii: warrior by Lars Meiertoberens
Confederacy: six people by Alfredo
Cothon: Harbor by Dolly Holmes
Cur: Horse by RIZCA
Daimyo: tairano masakado by Amethyst Studio
Dao Swordsman: dao by Michael T
Dar-e Mehr: Zoroastrianism Renee Ramsay-Passmore
Deutsches Heer: Pickelhaube Helmet by Henry Ryder
Dojo: Kendo by Jems Mayor
Eagle Warrior: Eagle by Gab Bandala
Estancia: cattle by Symbolon 
Examination Hall: testing by Creative Stal
Factorij: Castle by Kusdarti
Fale Tele: pavilion by Eucalyp
Folwark: Shovel and Pitchfork by Symbolon 
Forum Romanum: Pillar by Mochamad Ilham
Galleon: galleon ship by Kevin
Golden Horde: Horse by Nestor Arellano
Goumier: dagger by iconcheese
Great Bombard: Cannon by Vectors Market
Gribeauval: Cannon by Melvin Salas
Gripen: Jet by Setyo Ari Wibowo
Guri Reservoir: Dam by Adrien Coquet
Halberdman: Halbert by L Nimis
Hammam: sauna by Adrien Coquet
Harvard University: Harvard University by NATAPON CHANTABUTR
Hellenic Trireme: Bireme by Ravignir (not from the Noun Project)
Hippodrome: Hippodrome by P Thanga Vignesh
Iroquois Warrior: Axe by Eucalyp
Itaipu Dam: Dam by Chanut is Industries
Jarliq: Scroll by Gregor Cresnar
Kapal Jung: junk by Grégory Montigny
Khopesh: Khopesh by Ian Childers
Koa: Spear by Loritas Medina
Landscape Garden: landscaping by Radon5
Landwehr: forester by Alexander Wiefel
Lithium Mine: 003 Lithium Li by Joel Wisneski
Llama Farm: Llama by Jalele
Longship: Viking Ship by Ole Sturm
Madrasah: Mustansiriya Madrasa by József Balázs-Hegedüs
Mamluk: scheich by Andrejs Kirma
Mandir: katas raj temple by Vectors Point
Mapuche: Spear by Made AU
Metalworker: metalworking by Ben Avery
Mission: Cathedral by IconMark
Mughal Elephant: Asian elephant by Hannah Storey
Numidian: Spear by sam maulidna
Music Group: Music by Icon Lauk
Obsidian Warrior: Stone Age Knife by Misha Petrishchev
Orchestra: orchestra by Adrien Coquet
Oromo: Maasai by Smashing Stocks
Pioneer: American Eagle by Raymond
Pucara: Airplane by icon 54
Qolqe Qhoya: Mine by David Khai
Qullqa: pachacamac by Start Up Graphic Design
Redcoat: Queen's Guard by Luis Prado
Riad: house plant by corpus delicti
Rock-Hewn Church: Monument by IconMark
Sabum Kibittum: spear and shield by Andrejs Kirma
Sala: Sala by Krisada
Seowon: hanok by Joh Gurn
Shadoof: irrigate by Eucalyp
Sofa: Archer by Evgeni Moryakov
Sorbonne: books by Jakub Čaja
Streltsy: Rifle by Maurizio Fusillo
Taco and Burrito Restaurant: Taco by Rasama studio
Textile Mill: silk by luketaibai
Tipi: Tipi by Chanut is Industries
Tiuna: military vehicle by Atif Arshad
Treasury: gold by Delwar Hossain
Trigarante: bicorne by Mohamed Amine BENZAKOUR
Tunel de la Linea: Tunnel by Viktor Feduyk (Tim P)
Uhlan: Spear by Firza Alamsyah
Viking Longhouse: building by evan gerard kalerasan
Yurt: Ger by Laurens


I would like to thank the following people for contributing to this mod:
Ajmak, for suggesting many important improvements and balance changes to the game.
Caballero von Pancakeco, for suggesting new components to add to extend this mod to support Latin American_Civs.  